*****************
*****************
################*
#              #*
#        .     #*
#       $      #*
#       $@     #*
#              #*
#              #*
#              #*
################*
*****************
*****************
*****************