*****************
*****************
################*
#              #*
#     ?   .    #*
#     ?   $  ? #*
# $$    @      #*
#     $        #*
#     $        #*
#              #*
################*
*****************
*****************
*****************