^^^^^^^^^^^^^^^^^
^^^^^^^^^^^^^^^^^
################^
#              #^
#        .     #^
#     ?  $  ?  #^
# $$    @      #^
#              #^
#              #^
#              #^
################^
^^^^^^^^^^^^^^^^^
^^^^^^^^^^^^^^^^^
^^^^^^^^^^^^^^^^^