*****************
*****************
*****************
*****************
*****#####*******
*****#.$@#*******
*****#####*******
*****************
*****************
*****************
*****************
*****************
*****************
*****************