************************
************************
******####**************
******#  ###************
******#  $ #************
******#    #************
******### ###***********
******#    .#***********
******#  @ .#***********
******#  $  #***********
******###  ##***********
********####************
************************
************************