************************
************************
******####**************
******#  ###************
******#    #************
******#    #************
******### ###***********
******#     #***********
******#  @ .#***********
******#  $  #***********
******###  ##***********
********####************
************************
************************