*****************
*****************
*****####********
*****#  ###******
*****#  $ #******
*****#    #******
*****### ###*****
*****#    .#*****
*****#  @ .#*****
*****#  $  #*****
*****###  ##*****
*******####******
*****************
*****************