************************
************************
***********####*********
*******#####  #*********
*******#   $  #*********
*******# ?.#  #*********
*******## ## ##*********
*******#      #*********
*******# @#   #*********
*******#  #####*********
*******####*************
************************
************************
************************