*****************
*****************
********####*****
****#####  #*****
****#   $  #*****
****# ?.#  #*****
****## ## ##*****
****#      #*****
****# @#   #*****
****#  #####*****
****####*********
*****************
*****************
*****************