*****************
*****************
******#####******
****###   #******
****#   # ##*****
****#  ??+ #*****
****## ? $?##****
*****# # #  #****
*****#      #****
*****###  ###****
*******####******
*****************
*****************
*****************
