************************
************************
************************
*******####*####********
*******#  ###  #********
*******# $ ? $ #********
*******#   . @ #********
*******### .$###********
*********# . #**********
*********#####**********
************************
************************
************************
************************