************************
************************
*********#####**********
*********#   #**********
********##$# ###********
********#   $@ #********
********# #  # #********
********# #. . #********
********#   ####********
********#####***********
************************
************************
************************
************************
