*****************
*****************
*****#####*******
*****#   #*******
****##$# ###*****
****#   $@ #*****
****# #  # #*****
****# #. . #*****
****#   ####*****
****#####********
*****************
*****************
*****************
*****************
