*****************
*****************
*******####******
****#####  #*****
****#   ?  #*****
****# ?.#  #*****
****## ## ##*****
****# $    #*****
****# @#   #*****
****#  #####*****
****####*********
*****************
*****************
*****************