************************
************************
************####********
********#####  #********
********#   ?  #********
********# ?.#  #********
********## ## ##********
********# $    #********
********# @#   #********
********#  #####********
********####************
************************
************************
************************