*****************
*****************
*****#####*******
*****#   ###*****
*****# .   #*****
*****## $  #*****
*****####$##*****
*****#  $ ##*****
*****# @   #*****
*****###. .#*****
*******#####*****
*****************
*****************
*****************