************************
************************
****####****************
****#  ####*************
****#     #*************
****#     #*************
****### ###*************
****# $$$ ##************
****# ...@ #************
****####   #************
*******#####************
************************
************************
************************