*****************
*****************
*****####********
*****#  ####*****
*****#     #*****
*****# #.  #*****
****##?##$##*****
****#      #*****
****# # @  #*****
****#    ###*****
****######*******
*****************
*****************
*****************
