*****************
*****************
****########*****
****#  #   #*****
****# .  . #*****
****#      #*****
****#  $ ###*****
****#      #*****
****#  $   #*****
****# @ #  #*****
****########*****
*****************
*****************
*****************