************************
************************
*******########*********
*******#  #   #*********
*******# .  . #*********
*******#      #*********
*******#  $ ###*********
*******#      #*********
*******#  $   #*********
*******# @ #  #*********
*******########*********
************************
************************
************************