************************
************************
*******########*********
*******#  #   #*********
*******#    . #*********
*******#      #*********
*******#    ###*********
*******#      #*********
*******#  $   #*********
*******# @ #  #*********
*******########*********
************************
************************
************************