*****************
*****************
****########*****
****#   #  #*****
****#      #*****
****## #.  #*****
****#    ###*****
****# # . #******
****# $$# #******
****###  @#******
******#####******
*****************
*****************
*****************
