*****************
*****************
********####*****
*****####  #*****
****## $   #*****
****#  # #$#*****
****#.@.   ##****
****## # #  #****
*****#      #****
*****#  #####****
*****####********
*****************
*****************
*****************