************************
************************
*********#####**********
*********#...#**********
**********#$ #**********
**********#@ ##*********
*********# $$ #*********
*********#   ##*********
*********#  ##**********
*********#####**********
************************
************************
************************
************************