*****************
*****************
*******####******
*****###   #*****
*****#     #*****
*****#  #.###****
*****##@$$$ #****
******#.#.# #****
******#     #****
******#  ####****
******####*******
*****************
*****************
*****************