*****************
*******####******
*****###  ###****
*****#   ?$ #****
*****# #  # #****
*****#   ?? #****
*****###  #@#****
*******# ?? #****
*******#  # #****
*******# ?. #****
*******#  ###****
*******####******
*****************
*****************
