*****************
*****************
*****####********
*****#  ###******
*****#    #******
*****#    #******
*****#  $.##*****
*****#     #*****
*****#  @ .#*****
*****#  $  #*****
*****###  ##*****
*******####******
*****************
*****************