************************
************************
*********####***********
*********#  ###*********
*********#    #*********
*********#    #*********
*********#  $.##********
*********#     #********
*********#  @ .#********
*********#  $  #********
*********###  ##********
***********####*********
************************
************************