*****************
*****************
*****************
*****#####*******
****##   ###*****
****# . .  #*****
****# # ## ##****
****#    $$@#****
****### #   #****
******#   ###****
******#####******
*****************
*****************
*****************