*****************
*****************
*****************
******######*****
****###  . #*****
****#. $ # #*****
****#$ .$  #*****
****#   #$##*****
****##. @  #*****
*****#######*****
*****************
*****************
*****************
*****************