*****************
*****************
*******#####*****
******##   ##****
*****## .#  #****
****##   @  #****
***##    #  #****
***#  $ #####****
***# ? ##********
***#  ##*********
***####**********
*****************
*****************
*****************
