*****************
*****************
****########*****
***##      ##****
***# .####  #****
***# .    # #****
***# ? $$ # #****
***# ?## #  #****
***# +   # ##****
***# $###  #*****
***##     ##*****
****#######******
*****************
*****************