************************
************************
************************
*********#####**********
*********#   #**********
********##   #**********
********# $ ##**********
********# @ .#**********
********######**********
************************
************************
************************
************************
************************