*****************
*****************
*****************
*****#####*******
*****#   #*******
****##   #*******
****# $ ##*******
****# @ .#*******
****######*******
*****************
*****************
*****************
*****************
*****************