*****************
***###########***
**##    #    ##**
**# .$$. .$$. #**
**# $..$ $..$ #**
**# .$$...$$. #**
**# $..$ $..$ #**
**## $$.?.$$ ##**
**# $..$ $..$ #**
**# .$$...$$. #**
**# $..$ $..$ #**
**# .$$.@.$$. #**
**##    #    ##**
***###########***
