*****************
*****************
*****************
******######*****
*****##  . #*****
*****# $ # #*****
*****# .$  #*****
*****#  #$##*****
*****#. @ #******
*****#######*****
*****************
*****************
*****************
*****************