*****************
*****************
*********#####***
*********#.  #***
*********#.# #***
***#######.# #***
***# @ $ $ $ #***
***# # # # ###***
***#   $    #****
***##  . ###*****
****######*******
*****************
*****************
*****************
