*****************
*****************
*********#####***
*********#.  #***
*********#.# #***
***#######.# #***
***# @ $ $ $ #***
***# # # # ###***
***#       #*****
***#########*****
*****************
*****************
*****************
*****************
