*****************
*****************
*****####********
*****#  #********
*****#$ #********
*****#  #*####***
**#### ####  #***
**#   .. ..  #***
**#  $?. ?.$@##**
**#   #$ $#$  #**
**#####   #   #**
******#########**
*****************
*****************
