************************
************************
********#####***********
********#   ##**********
*******## #$ ##*********
*******# $    #*********
*******#. .#  #*********
*******### @ ##*********
*********# # #**********
*********#   #**********
*********#####**********
************************
************************
************************
