*****************
*****************
*****#####*******
*****#   ##******
****## #$ ##*****
****# $    #*****
****#. .#  #*****
****### @ ##*****
******# # #******
******#   #******
******#####******
*****************
*****************
*****************
