*****************
****####*********
****#  #*********
****#$ #*********
****#  #*####****
**### ####  #****
**#  .. ..  ###**
**# $?. ?.$@  #**
**## #$ $#$ # #**
***# #   #  # #**
***#  ######  #**
***##        ##**
****##########***
*****************

