*****************
*****************
******#####******
****###   #******
****# $ # ##*****
****# #  . #*****
****#    # #*****
****## #   #*****
*****#@  ###*****
*****#####*******
*****************
*****************
*****************
*****************
