*****************
******###********
*****## #*####***
****##  ###  #***
***## $      #***
***#   @$ #  #***
***### $###  #***
*****#  #..  #***
****## ##.# ##***
****#      ##****
****#     ##*****
****#######******
*****************
*****************
