*****************
*****************
*****##*#####****
****##*## . #****
****#*## $. #****
*****## $   #****
****## $@ ###****
****# $  ##******
****#.. ##*##****
****#   #*##*****
****#####*#******
*****************
*****************
*****************