*****************
*****************
****###########**
****#     #  @#**
**### $ $$#   #**
**# ##$    $$ #**
**#  #  $ #   #**
**###### ######**
**#.. ..$ #******
**# ..    #******
**#  ..####******
**######*********
*****************
*****************
