*****************
***###########***
*###.  .$.  .###*
**## $  $  $ ##**
***## ..$.. ##***
****##$#$#$##****
*****#.$ $.#*****
*****#  @  #*****
*****### ###*****
****## $ $ ##****
****#.  $  .#****
****### . ###****
******#####******
*****************
