************************
************************
**********#####*********
********###   #*********
********# $ # ##********
********# #  . #********
********# .  # #********
********##$#.$ #********
*********#@  ###********
*********#####**********
************************
************************
************************
************************