*****************
*****************
******#####******
****###   #******
****# $ # ##*****
****# #  . #*****
****# .  # #*****
****##$#.$ #*****
*****#@  ###*****
*****#####*******
*****************
*****************
*****************
*****************