***###*###*###***
**##  # @ #  ##**
**#  $#$ $#$  #**
**# . . . . . #**
***##$#$ $#$##***
**# . . . . . #**
**#  $ $#$ $  #**
**# . . . . . #**
***##$#$ $#$##***
**# . . . . . #**
**#  $#$ $#$  #**
**##  #   #  ##**
***###*###*###***
*****************