*****************
*****************
****####*********
****#  ######****
****#       #****
***## # #.$ #****
***#  ? ## ##****
***# ?? # @#*****
***###   ? #*****
*****####  #*****
********####*****
*****************
*****************
*****************