***###########***
***#    ?    #***
***# $$ ## $ #***
***#  $..#$$ #***
***# ##?.?.  #***
***#?#..@..#?#***
***#  .?.?## #***
***# $$#..$  #***
***# $ ## $$ #***
***#    ?    #***
***###########***
*****************
