**#############**
**#     $   . #**
**#.$ $### ?$ #**
**# ?? ## .?  #**
**#  .$#..$ $ #**
**# # .$.$### #**
**#$##..@..##$#**
**# ###$.$. # #**
**# $ $..#$.  #**
**#  ?. ## ?? #**
**# $? ###$ $.#**
**# .   $     #**
**#############**
*****************