*****************
*****#######*****
*****#  ?  #*****
*****#  @  #*****
*****##$#.##*****
*****#  #  #*****
*****# $#. #*****
*****#  #  #*****
****## ## ##*****
****#  ? ? #*****
****#   ?  #*****
****###   ##*****
******#####******
*****************