
************************
************************
********#####***********
********#   ##**********
*******##.#$ ##*********
*******# $    #*********
*******#. .#$ #*********
*******### @ ##*********
*********# # #**********
*********#   #**********
*********#####**********
************************
************************
************************
