*****************
*****************
*****#####*******
*****#   ##******
****##.#$ ##*****
****# $    #*****
****#. .#$ #*****
****### @ ##*****
******# # #******
******#   #******
******#####******
*****************
*****************
*****************
