*****#####*******
*****#   #####***
***### #     ##**
***#  ? ####  #**
***#  ? ##  # #**
***#  ?  ?? # #**
***#   #    # #**
***#@#?? ? ## #**
***###  #$  # #**
****# .$ .? # #**
****#   #  #  #**
****##  #    ##**
*****#########***
*****************