*****************
***********#*****
****#*****###****
***###***## ##***
**## ##*##   ##**
*## . ### .$. ##*
## $.$ # .$ $. ##
#   ?  @ $ ? $  #
## $.$ # .$ $. ##
*## . ### .$. ##*
**## ##*##   ##**
***###***## ##***
**********###****
*****************