*****************
*****************
***####**####****
***#  ####  #****
***#        #****
***#  ####  #****
***##@##. $##****
***#  #.$? #*****
***#      ##*****
***#  #  ##******
***#######*******
*****************
*****************
*****************