*****************
*****************
***********#####*
***#########   #*
*### $ $ $ $.  #*
*#  .$.$ $.$.# #*
*# #.?..@..?.# #*
*# #.$.$ $.$.  #*
*#  .$ $ $ $ ###*
*#   #########***
*#####***********
*****************
*****************
*****************
