************************
************************
******##########********
******#        #********
******#  $ $ $ #********
******#        #********
******#        #********
******# $  @ $ #********
******#    $   #********
******#        #********
******##########********
************************
************************
************************
************************
************************
************************