************************
************************
****################****
****#              #****
****#        .     #****
****#     ?  $  ?  #****
****#       @      #****
****#              #****
****#              #****
****#              #****
****################****
************************
************************
************************